##########################
#    #                   #
#    #                   #
#    ####                #
#                        #
#         ####           #
#                        #
#                        #
                         #
                         #
                         #
#                        #
#                        #
#                        #
#                        #
#                        #
#                        #
#                        #
#######   ################
#######   ################
#    #                   #
#    #                   #
#    ####                #
#                        #
#         ####           #
#                        #
#                        #
                         #
                         #
                         #
#                        #
#                        #
#                        #
#                        #
#                        #
#                        #
#                        #
#################   ######
###################   ####
#    #                   #
#    #                   #
#    ####                #
#                        #
#         ####           #
#                        #
#                        #
                         #
                         #
                         #
#                        #
#                        #
#                        #
#                        #
#                        #
#                        #
#                        #
##########################
