##########################
#    #                   #
#    #                   #
#    ####                #
#                        #
#         ####           #
#                        #
#                        #
##########################
